00S0111111111111100000111
0000010001000000000000001
0000010001000000000000001
0000010000001000111110001
1000010000001000110000001
1000111000001000110000001
1000111000001000110000001
1000111000001000111111111
1000000000001000110000001
1000000000001000110000001
1000000011001000110000001
0000100011001000000010001
0000100000001000000010001
0000100000001000000010001
0000100011111111111110E01